11111111111111111111
10000000010001000101
10010001010101010101
10000001000100010001
10010001111111011001
10010000000100001101
10010000000000000001
10000000000100000001
10000000000100000001
10000101100111101011
10000101110110100011
10000001000100011001
10011000000000001001
10000001000110001001
10000000000100001001
10011101011010110001
10010010110111000001
10000001000110011011
10000000001100111111
1e1111111111m1111111